00000000000000000000
00000000000000000000
00000000000000000000
00000000000000000000
00000000000000000000
01010101110100101000
01010100100110101000
00101000100101100000
00101001110100101000
00000000000000000000
00000000000000000000
00000000000000000000
00000000000000000000
00000000000000000000
00000000000000000000
00000000000000000000
00000000000000000000
00000000000000000000
00000000000000000000
00000000000000000000
