00000011000010000000
00005101100011000000
00145183647214740004
00145183647214700064
00105518364720000836
01051113647200008311
05511136472000001117
05101113640000041161
01101113600000111364
00141011000001411836
01111110000011183611
01471100000117183617
01471000001114718311
01470000011114718114
01470000171111111647
01400001011214711364
02000021001110001200
02000100220111011122
00074836472141113647
00001000000000000000
