00000000000000000000
00000000000000000000
00000000000000000000
00000000000000000000
00000000000000000000
01010101110000000000
01010100100000000000
00101000100000000000
00101001100000000000
00001000010000000000
00000011000000000000
00000111000000000000
00000000010000000000
01000000000100000000
10111000010000000000
00000000000000000000
00000000000000000000
00000000000100000000
00000000000000000000
00000000000000000000
