00000000000000000000
00000000111100000000
00000000100100000000
00000000100100000000
00000000100100000000
00000000111100000000
00000000000000000000
00000000000000000000
00000000000000000000
00000000000000000000
00000001000000000000
00000001000110000000
00000001000011000000
00000001000001000000
00000001000001000000
00000001000010000000
00000001000010000000
00000001100100000000
00000000111100000000
00000000000000000000
