00000000000000000000
00000022220000000000
00000220002000000000
00000200000000000000
00000200000000000000
00000200022220000000
00000220000020000000
00000020000020000000
00000022202200000000
00000000222000000000
00000000000000000000
00000000000000000000
00000000000000000000
00000000000000000000
00000000000000000000
00000000000000000000
00000000000000000000
00000000000000000000
00000000000000000000
00000000000000000000
