00000000000000000000
00000222222220000000
00002200000022000000
00022000000002200000
00020000300000200000
00020300333000220000
00020330303300020000
00020033300300020000
00020003300330020000
00020000300030020000
00020000000000220000
00022000000000200000
00002000000002200000
00002000000022000000
00002000002220000000
00000000002000000000
00000000000000000000
00000000000000000000
00000000000000000000
00000000000000000000
