00000000000000000000
00000000000000000000
00000000000000000000
00000000000000020000
00022200000200220000
00020020000200200000
00200020000222000000
00200002000202000000
00200002000200000000
00200002000200200000
00220020000200020000
00002200000200020000
00000000000000002000
00000000000000000000
00000000000000000000
00000000000000000000
00000000000000000000
00000000000000000000
00000000000000000000
00000000000000000000
