00000222202222000000
00002202200000000000
00000000000000000000
00011111000000000000
00011111100000000000
01110001110110000000
00000111110011000000
00100000000001000000
00100000000001000010
00000000100001000010
10000000100001000010
00101000111111000010
00101000110000000010
00000001110000000000
00010000000000000000
10000000000000000000
10000000000000000000
01100000000000000000
00000000000000000000
00000000000000000000
