22222222220000022222
22222222220000022222
22200000000000022222
22000010000000022222
22000110000000022222
22000111000000022222
22000111000000022222
22000111000000002222
22000000000011000222
22000000000011100222
22000000000011100022
22000000000001110022
22000000000000110022
22000000000000000022
22200000000000000022
22220000000000000022
22222000000000000222
22222220000222222222
22222222222222222222
22222222222222222222
