00000002200000000000
00000222002000220000
00022200000000020000
00020000000000022000
00220000000000002000
00200000000000002000
00200000000000002200
00200000000000000200
00200000000000002200
00200000000000002000
00200000000000022000
00200000000000020000
00200000000000220000
00200000000002200000
00200000000002000000
00200000000022000000
00200000000220000000
00000000000000000000
00000000000000000000
00000000000000000000
